Final Project
An Interactive Fiction by Kristen Ho (kho11) and Martina Stepisnik (mstepisn)
Release 1 / Serial number 150605 / Inform 7 build 6L38 (I6/v6.33 lib 6/12N) SD

Tower
A spacious room with tall, open windows. You can see the purple of the sun and the three pink moons from here, against a backdrop of green sky. The middle of the room is open, allowing you to see the bookshelves below. The stairs on the south side of the tower lead down into the Library.

>down
Library
A room full of books and desks. The Throne Room is east of here.

You can see bookshelf (on which are a pile of books and a Legend of the Bad Dude), bookcase (closed), the desk (closed) and chair here.

>x books
You flick through the pages of one of the heavier books. "Consider the function  f(x) = { x^{5} * e^x (4x+3) / 5^{ln x} (3-x)^{2} }. Find an equation of the line tangent to the graph of f at x = 1." Ummm.... no.

>x books
You pick up one of the books and flip to a random page. "Consider the infinite Atwood's machine shown below. A string passes over each pulley, with one end attached to a mass and the other end attached to another pulley. All the masses are equal to m, and all the pulleys and strings are massless. The masses are held fixed and then simultaneously released. What is the acceleration of the top mass?"
You carefully close the book and replace it, as if any sudden  movements will incur its wrath.

>x books
 You eye the books skeptically. Maybe this time you'll pick up something that isn't a textbook? You try your luck: "You visit a remote desert island inhabited by one hundred very friendly dragons, all of whom have green eyes. They haven't seen a human for many centuries and are very excited about your visit. They show you around their island and tell you all about their dragon way of life (dragons can talk, of course). They seem to be quite normal, as far as dragons go, but then you find out something rather odd. They have a rule on the island which states that if a dragon ever finds out that they have green eyes, then at precisely midnight on the day of this discovery, they must relinquish all dragon powers and transform into a longtailed sparrow. However, there are no mirrors on the island, and they never talk about eye color, so the dragons have been living in blissful ignorance throughout the ages. Upon your departure, all the dragons get together to see you off, and in a tearful farewell you thank them for being such hospitable dragons. Then you decide to tell them something that they all already know (for each can see the colors of the eyes of the other dragons). You tell them all that at least one of them has green eyes. Then you leave, not thinking of the consequences (if any). Assuming that the dragons are (of course) infallibly logical, what happens? If something interesting does happen, what exactly is the new information that you gave the dragons?" Nope. Nuh-uh. Never again.

>x books
 NO.

I beg your pardon?

I beg your pardon?

>x books
 NO.

>east
Throne Room
A huge, open space, complete with pillars, paintings, and a beautiful view of the outside world that you will never get to explore.

A flag hangs above the royal Standard Lecture Hall Seat. Three horizontal bands of red, white, and blue superimposed by the Croatian coat of arms.

In the center, near the back of the room you see the throne of Cramalot's ruler: the Standard Lecture Hall Seat, barely comfortable fabric, plastic backing, one of those little table things you can pull up from the side. It's not exactly glorious, and so old you can see the springs pressing up from within the seat. Even so, it beckons to you.

>west
Library
A room full of books and desks. The Throne Room is east of here.

You can see bookshelf (on which are a pile of books and a Legend of the Bad Dude), bookcase (closed), the desk (closed) and chair here.

>x desk
You see nothing special about the desk.

>x bookcase
You see nothing special about bookcase.

>open bookcase
You open bookcase, revealing a flower key.

* * *

>down
Library
A room full of books and desks. The Throne Room is east of here.

You can see bookshelf (on which are a pile of books and a Legend of the Bad Dude), bookcase (closed), the desk (closed) and chair here.

>take desk
The desk is made of the finest mahogony you've ever seen.  As pretty as it is, it's too heavy for you to carry by yourself.  Best leave it where it is...

* * *

>down
Library
A room full of books and desks. The Throne Room is east of here.

You can see bookshelf (on which are a pile of books and a Legend of the Bad Dude), bookcase (closed), the desk (closed) and chair here.

>take bookcase
That's fixed in place.

* * *

>down
Library
A room full of books and desks. The Throne Room is east of here.

You can see bookshelf (on which are a pile of books and a Legend of the Bad Dude), bookcase (closed), the desk (closed) and chair here.

>open bookcase
You open bookcase, revealing a flower key.

>take key
Taken.

>unlcok desk
That's not a verb I recognise.

>unlock desk
(with the flower key)
You unlock the desk.

>open desk
You open the desk, revealing a mirror.

>take mirror
Taken.

>east
Throne Room
A huge, open space, complete with pillars, paintings, and a beautiful view of the outside world that you will never get to explore.

A flag hangs above the royal Standard Lecture Hall Seat. Three horizontal bands of red, white, and blue superimposed by the Croatian coat of arms.

In the center, near the back of the room you see the throne of Cramalot's ruler: the Standard Lecture Hall Seat, barely comfortable fabric, plastic backing, one of those little table things you can pull up from the side. It's not exactly glorious, and so old you can see the springs pressing up from within the seat. Even so, it beckons to you.

>sit in seat
A booming CRASH resounds throughout the castle as a huge dragon comes crashing down through the roof of the Throne Room, leaving a giant hole in it and scattering rubble everywhere.

>take flag
The gargantuan dragon glares at you, blocking your way to the flag.

>show mirror to dragon
You throw the mirror at the dragon. Its dragon instincts take over and it catches the shiny thing, and looks into the glassy surface, admiring its reflection. 
 "Wait, I have green eyes?!" it says, before poofing commically into a tiny bird. The mirror clatters to the ground, and the bird squawks and flies off, embarrassed.

>take flag
You triumphantly retrieve the glorious flag from its position above the Seat. The red, white, and blue fabric flaps majestically in the wind as everything else fades to white..

 As the white begins to fade out, you realize your surroundings have changed and you seem to be underwater!  After a moment of panicked flailing, you realize you are having no trouble breathing and settle down.  Looking around, you notice you are in what seems to be some sort of lounge area.  "Well, here we go again..." you think to yourslef.

Lounge
A minimally-furnished room that contains a tan carpet on top of which are two white sofas separated by a coffee table.  There is also a seaweed plant in a pot in the corner of the room.  The back wall is made entirely of glass, and you can see various sea creatures swimming about and a beautiful view of the outside world that you will never get to explore.

    *** To be continued... ***

Would you like to RESTART, RESTORE a saved game, QUIT or UNDO the last command?

* * *

>take key
Taken.

>unlock desk
(with the flower key)
You unlock the desk.

>take mirror
You can't see any such thing.

>x desk
You see nothing special about the desk.

>open desk
You open the desk, revealing a mirror.

>take mirrior
You can't see any such thing.

>take mirror
Taken.

* * *

>show mirror to dragon
You can't see any such thing.

>take flag
A booming CRASH resounds throughout the castle as a huge dragon comes crashing down through the roof of the Throne Room, leaving a giant hole in it and scattering rubble everywhere.

>show mirror to dragon
You throw the mirror at the dragon. Its dragon instincts take over and it catches the shiny thing, and looks into the glassy surface, admiring its reflection. 
 "Wait, I have green eyes?!" it says, before poofing commically into a tiny bird. The mirror clatters to the ground, and the bird squawks and flies off, embarrassed.

>take flag
A booming CRASH resounds throughout the castle as a huge dragon comes crashing down through the roof of the Throne Room, leaving a giant hole in it and scattering rubble everywhere.

* * *

>sit on seat
A booming CRASH resounds throughout the castle as a huge dragon comes crashing down through the roof of the Throne Room, leaving a giant hole in it and scattering rubble everywhere.

>show mirror to  dragon
You throw the mirror at the dragon. Its dragon instincts take over and it catches the shiny thing, and looks into the glassy surface, admiring its reflection. 
 "Wait, I have green eyes?!" it says, before poofing commically into a tiny bird. The mirror clatters to the ground, and the bird squawks and flies off, embarrassed.

>take flag
You triumphantly retrieve the glorious flag from its position above the Seat. The red, white, and blue fabric flaps majestically in the wind as everything else fades to white..
this is before
Lounge
A minimally-furnished lounge area that contains a tan carpet on top of which are two white sofas separated by a coffee table.  There is also a seaweed plant in a pot in the corner of the room.  The back wall is made entirely of glass, and you can see various sea creatures swimming about and a beautiful view of the outside world that you will never get to explore.

this is after

    *** To be continued... ***

Would you like to RESTART, RESTORE a saved game, QUIT or UNDO the last command?

* * *

>sit in seat
A booming CRASH resounds throughout the castle as a huge dragon comes crashing down through the roof of the Throne Room, leaving a giant hole in it and scattering rubble everywhere.

>sit in seat
The dragon roars at you, spitting fire and smoke in your general direction.

>show mirror to dragon
You throw the mirror at the dragon. Its dragon instincts take over and it catches the shiny thing, and looks into the glassy surface, admiring its reflection. 
 "Wait, I have green eyes?!" it says, before poofing commically into a tiny bird. The mirror clatters to the ground, and the bird squawks and flies off, embarrassed.

>sit in seat
You get onto the Standard Lecture Hall Seat.

You can feel the springs no matter what position you try to sit in. Maybe you should just not sit here.

* * *

>take flag
A booming CRASH resounds throughout the castle as a huge dragon comes crashing down through the roof of the Throne Room, leaving a giant hole in it and scattering rubble everywhere.

* * *

>show mirror to dragon
You throw the mirror at the dragon. Its dragon instincts take over and it catches the shiny thing, and looks into the glassy surface, admiring its reflection. 
 "Wait, I have green eyes?!" it says, before poofing commically into a tiny bird. The mirror clatters to the ground, and the bird squawks and flies off, embarrassed.

>take flag
You triumphantly retrieve the glorious flag from its position above the Seat. The red, white, and blue fabric flaps majestically in the wind as everything else fades to white..

Lounge
A minimally-furnished lounge area that contains a tan carpet on top of which are two white sofas separated by a coffee table.  There is also a seaweed plant in a pot in the corner of the room.  Weird choice of decor, but whatever.  The back wall is made entirely of glass, and you can see various sea creatures swimming about and a beautiful view of the outside world that you will never get to explore.   "Where the hell am I now?" you think to yourself... 

    *** To be continued... ***

Would you like to RESTART, RESTORE a saved game, QUIT or UNDO the last command?

* * *

>unlock desk
(with the flower key)
You unlock the desk.

>open dek
You can't see any such thing.

>open desk
You open the desk, revealing a mirror.

* * *

>take flag
A booming CRASH resounds throughout the castle as a huge dragon comes crashing down through the roof of the Throne Room, leaving a giant hole in it and scattering rubble everywhere.

>take flag
The gargantuan dragon glares at you, blocking your way to the flag.

>take flag
The gargantuan dragon glares at you, blocking your way to the flag.

* * *

>show mirror to dragon
You throw the mirror at the dragon. Its dragon instincts take over and it catches the shiny thing, and looks into the glassy surface, admiring its reflection. 
 "Wait, I have green eyes?!" it says, before poofing commically into a tiny bird. The mirror clatters to the ground, and the bird squawks and flies off, embarrassed.

>take flag
The gargantuan dragon glares at you, blocking your way to the flag.

* * *

>down
Library
A room full of books and desks. The Throne Room is east of here.

You can see bookshelf (on which are a pile of books and a Legend of the Bad Dude), bookcase (closed), the desk (closed) and chair here.

>x bookcase
You see nothing special about bookcase.

>x legend
Long ago, five worlds coexisted in harmony, but everything changed when the Bad Dude attacked.

* * *

>down
Library
A room full of books and desks. The Throne Room is east of here.

You can see bookshelf (on which are a pile of books and a Legend of the Bad Dude), bookcase (closed), the desk (closed) and chair here.

>x legen
You can't see any such thing.

>x legend
<<insert foreshadowing story here>> 

Sounds stupid.

* * *

>down
Library
A room full of books and desks. The Throne Room is east of here.

You can see bookshelf (on which are a pile of books and a Legend of the Bad Dude), bookcase (closed), the desk (closed) and chair here.

>x legend
"Long ago, 5 rhelms lived in harmony.  Each of these rhelms contained one of the pieces of five, which, when all brought together, would grant the bearer unlimited power.  Legend tells of a bad dude who wanted to rule the world (as bad dudes usually do)  In order to do this, he had to travel through the different rhelms and collect each piece of five.  A great warrior, chosen by the rulers of the rhelm, followed him through the rhelms and eventually put and end to his quest.  To ensure this never happened again, the rhelms were disconennected from each other and one could only travel between them under very specific circumstances." 

Sounds stupid.

>x books
You flick through the pages of one of the heavier books. "Consider the function  f(x) = { x^{5} * e^x (4x+3) / 5^{ln x} (3-x)^{2} }. Find an equation of the line tangent to the graph of f at x = 1." Ummm.... no.

* * *

Final Project
An Interactive Fiction by Kristen Ho (kho11) and Martina Stepisnik (mstepisn)
Release 1 / Serial number 150605 / Inform 7 build 6L38 (I6/v6.33 lib 6/12N) SD

Tower
A spacious room with tall, open windows. You can see the purple of the sun and the three pink moons from here, against a backdrop of green sky. The middle of the room is open, allowing you to see the bookshelves below. The stairs on the south side of the tower lead down into the Library.

>x window
You can't see any such thing.

* * *

>take key
Taken.

>open desk
It seems to be locked.

>use key
That's not a verb I recognise.

>put key in desk
the desk is closed.

>open desk
It seems to be locked.

>x desk
You see nothing special about the desk.

>unlock desk
(with the flower key)
You unlock the desk.

* * *

>sit in seat
A booming CRASH resounds throughout the castle as a huge dragon comes crashing down through the roof of the Throne Room, leaving a giant hole in it and scattering rubble everywhere.

>use mirror
That's not a verb I recognise.

>show mirror to dragon
You throw the mirror at the dragon. Its dragon instincts take over and it catches the shiny thing, and looks into the glassy surface, admiring its reflection. 
 "Wait, I have green eyes?!" it says, before poofing commically into a tiny bird. The mirror clatters to the ground, and the bird squawks and flies off, embarrassed.

* * *

Final Project
An Interactive Fiction by Kristen Ho (kho11) and Martina Stepisnik (mstepisn)
Release 1 / Serial number 150605 / Inform 7 build 6L38 (I6/v6.33 lib 6/12N) SD

Tower
A spacious room with tall, open windows. You can see the purple of the sun and the three pink moons from here, against a backdrop of green sky. The middle of the room is open, allowing you to see the bookshelves below. The stairs on the south side of the tower lead down into the Library.

>doen
That's not a verb I recognise.

>down
Library
A room full of books and desks. The Throne Room is east of here.

You can see bookshelf (on which are a pile of books and a Legend of the Bad Dude), bookcase (closed), the desk (closed) and chair here.

>take desk
The desk is made of the finest mahogany you've ever seen.  As pretty as it is, it's too heavy for you to carry by yourself.  Best just leave it where it is...

>take bookshelf
That's fixed in place.

>take bookcase
What is a library without bookshelves?  That should stay where it is.